1111111
1011101
1000101
1110001
1111101
1100001
1111111